ADENO	ADENO
ANTHRAX	ANTHRAX
BCG	BCG
cholera	cholera
IG	IG
DTAP	DTAP
HepB	HepB
HIB	HIB
POLIO	POLIO
HBIG	HBIG
HepA	HepA
HepC	HepC
Hep E	Hep E
HPV	HPV
FLU	FLU
H5N1 flu	H5N1 flu
Japanese encephalitis	Japanese encephalitis
Lyme disease	Lyme disease
MEASLES	MEASLES
RUBELLA	RUBELLA
MENING	MENING
MMR	MMR
VARICELLA	VARICELLA
MUMPS	MUMPS
H1N1 flu	H1N1 flu
PneumoPCV	PneumoPCV
PneumoPPV	PneumoPPV
RABIES	RABIES
ROTAVIRUS	ROTAVIRUS
Td	Td
TYPHOID	TYPHOID
VACCINIA	VACCINIA
VEE	VEE
YELLOWFEVER	YELLOWFEVER
ZOSTER	ZOSTER